####################
#.................##
#..................#
S..................#
##################.#
G...#..............#
###.#..............#
###................#
###...............##
##................##
##.#################
##..################
###.################
###.#..............#
###.########.#######
#.................##
#.................##
##...............###
##................##
####################
