####################
#.................##
#..................#
S..................#
##################.#
#...#..............#
###.#..............#
###................#
###...............##
##................##
##.#################
##..################
###.################
##..#..............#
##.#########.#######
#.................##
#.................##
##...............###
##................##
#################G##
